NO ./path_to_the_north_texture
SO ./path_to_the_south_texture
WE ./path_to_the_west_texture
EA ./path_to_the_east_texture

C 100,30,0
F 100,30,0


1111111111
11111111111111
1         11N000011
11111111111111
