SO ./path_to_the_south_texture
NO ./path_to_the_north_texture
WE ./path_to_the_west_texture
EA ./path_to_the_east_texture

F 100,30,0
C 200,30,0

1111111111111111111111111
1000000000110000000000001
1011000001110000000000001
1001000000000000000000001
100000000011000001110111111111111
11000001110101011111011110N0111
11110111111101011101111010001
11111111111111111111111111111
