NO ./textures/wall_north.xpm
SO ./textures/wall_south.xpm
WE ./textures/wall_west.xpm
F 220,100,0
C 100,100,255

111111
100001
10N001
100001
111111
