NO ./textures/wall_north.xpm
SO ./textures/wall_south.xpm
WE ./textures/wall_west.xpm
EA ./textures/wall_east.xpm
F 220,100,0
C 100,100,255

111111
10N001
100001
100001
111111
